%s ago=%s előtt
%s used of %s %s %%=%s használt a/z %s (%s %%)
1 m=1 p
10 s=10 mp
2 m=2 p
30 s=30 mp
5 m=5 p
Abort background operation=A háttérművelet megszakítása
Abort background process=A háttérfolyamat megszakítása
Active tunnels=Aktív alagutak
Activity=Tevékenység
ago=előtt
Airflow=Légáramlás
Alert Message=Figyelmeztető üzenet
Alerts=Figyelmeztetések
All Apps=Összes App
All VMs=Összes VM
Array Information=Tömb információ
Attention - operation continues in background=Figyelem - a működés a háttérben folytatódik
Battery charge=Akkumulátor töltés
BIOS dated=BIOS keltezés
Click to toggle CPU chart=Kattintson a CPU diagram váltásához
Click to toggle details=Kattintson a részletek váltásához
Close Tile=Csempe bezárása
Completed=Befejezve
Content Management=Tartalomkezelés
Counters info=Számláló info
Current operation %s on %s=Jelenlegi működés %s a/z **%s**
custom image=egyedi kép
Data is invalid=Az adatok érvénytelenek
default image=alapértelmezett kép
Docker Containers=Docker konténerek
Due in=Esedékes
Elapsed time=Eltelt idő
Errors info=Hiba info
Estimated finish=Becsült befejezés
failed device=sikertelen eszköz
Fan count=Ventilátorok száma
Fan Information=Ventilátor információk
FAN=VENTILÁTOR
Finding %s error=Talált: **%s** hiba
Finding %s errors=Talált: **%s** hibák
General info=Általános info
Go to CPU pinning settings=Menjen a CPU rögzítési beállításaihoz
Go to disk settings=Lépjen a lemezbeállításokhoz
Go to Docker settings=Nyissa meg a Docker beállításokat
Go to fan settings=Képjen a ventilátorbeállításokhoz
Go to identification settings=Lépjen az azonosítási beállításokhoz
Go to network settings=Nyissa meg a hálózati beállításokat
Go to scheduler settings=Lépjen az ütemező beállításaihoz
Go to Share settings=Lépjen a Megosztási beállításaihoz
Go to UPS settings=Lépjen az UPS beállításokba
Go to User settings=Lépjen a Felhasználói beállításokba
Go to VM settings=Lépjen a VM beállításokba
Go to VPN settings=Lépjen a VPN beállításokba
Handshake=Kézfogás
has=rendelkezik
healthy=egészséges
heat warning=túlmelegedés figyelmeztetés
Hide details=Részletek elrejtése
in progress=folyamatban
Inactive tunnels=Inaktív alagutak
inactive=Inaktív
Inbound=Bejövő
Information=Információ
Interface Information=Interfész információ
invalid device=érvénytelen eszköz
invalid devices=érvénytelen eszközök
Last check completed on %s=Az utolsó ellenőrzés befejezve: **%s**
Last check incomplete on %s=Az utolsó ellenőrzés nincs befejezve: **%s**
Last checked on %s=Utolsó ellenörzés a/z: **%s**
Lock sortable items=A rendezhető elemek zárolása
Maximum size=Maximális méret
Memory Utilization=Memóriahasználat
Mode of operation=Üzemmód
Motherboard Information=Alaplap információ
Network traffic=Hálózati forgalom
Next check scheduled on %s=A következő ellenőrzés ütemezve: **%s**
No docker containers defined=Nincsenek meghatározott dokkolótárolók
No running docker containers=Nem futnak docker konténerek
No running virtual machines=Nem futnak virtuális gépek
No shares present=Nincs jelen megosztás
No virtual machines defined=Nincs virtuális gép definiálva
Nominal power=Névleges teljesítmény
not received=nem érkezett
Notices=Megjegyzések
Notifications=Értesítések
Only PNG images are allowed=Csak PNG képek engedélyezettek!
Outbound=Kimenő
Output voltage=Kimeneti feszültség
Overall Load=Teljes terhelés
Parity disk not present=Paritáslemez nincs jelen
Parity disks not present=A paritáslemezek nincsenek jelen
Parity has not been checked yet=A paritást még nem ellenőrizték
Parity Information=Paritási információ
Parity is degraded=A paritás leromlott
Pool=Tömb
Power Status=Tápellátás állapota
Power=Tápellátás
Processor Information=Processzor információ
Put system to sleep=Tedd alvó állapotba a rendszert
Reboot the system=Indítsa újra a rendszert
Receive counters=Fogadási számlálók
Received packets=Fogadott csomagok
Runtime left=Futásidő hátralévő
Scheduled parity check is disabled=Az ütemezett paritásellenőrzés le van tiltva
Select Case Model=Válassza a Case Model lehetőséget
Select time frame=Válassza ki az időkeretet
Share count %s with %s cache only and %s encrypted=Megosztások száma: %s a/z %s csak a gyorsítótár és a titkosított %s
Shares Information=Megosztási információ
Show details=Részletek megjelenítése
Show Information=Információ megjelenítése
Shutdown the system=Állítsa le a rendszert
SMART error=SMART hiba
SMART health-check failed=SMART állapotellenőrzés sikertelen
SMART=SMART
sn=s/n
Start the array=Indítsa el a tömböt
Started only=Csak futó
Stop the array=Állítsa le a tömböt
Temp=Temp
This may leave an unknown state=Ez ismeretlen állapotot hagyhat maga után
This will put the system to sleep=Ez alvó állapotba helyezi a rendszert
This will reboot the system=Ezzel újraindul a rendszer
This will shutdown the system=Ez leállítja a rendszert
This will start the array=Ezzel elindul a tömb
This will stop the array=Ez leállítja a tömböt
Transmit counters=Átviteli számlálók
Transmitted packets=Továbbított csomagok
Unassigned Devices=Hozzá nem rendelt eszközök
Unlock sortable items=Oldja fel a rendezhető elemeket
UPS Load=UPS terhelés
UPS Model=UPS modell
UPS status=UPS állapot
Usable size=Használható méret
User count %s with %s unprotected=Felhasználók száma: %s a/z %s védtelen
Users Information=Felhasználói információ
utilization warning=használat figyelmeztetés
View Running Processes=Futó folyamatok megtekintése
Virtual Machines=Virtuális gépek
VPN Connections=VPN kapcsolatok
Warnings=Figyelmeztetések
ZFS=ZFS
