also remove image=kép eltávolítása is
Apply=Alkalmaz
Are you sure=Biztos vagy benne?
Cancel=Mégse
checking=ellenőrzés
Completely REMOVE=Teljes TÖRLÉS
Console=Konzol
day=nap
days=nap
disk image and definition=lemezkép és definíció
Disks=Lemezek
Donate=Adományozás
Done=Kész
Edit=Szerkesztés
Execution error=Végrehajtási hiba
Force Stop=Kényszer leállítás
Hibernate=Hibernált
Log for=Napló a/z:
log=Napló
Logs=Naplók
More Info=További információ
No=Nem
OK=OK
Ok=ok
Pause=Szünet
Proceed=Folytatás
Project Page=Projektoldal
Read Me First=Először olvass engem
Remove container=Távolítsa el a Kontainért
Remove definition=Definíció eltávolítása
Remove image=Kép eltávolítása
Remove VM=VM eltávolítása
Remove=Eltávolítás
Restart=Újraindítás
Resume=Folytatás
Start=Indítás
Stop=Leállítás
Support=Támogatás
Update container=Tároló frissítése
Update=Frissítés
Updating all Containers=Az összes Kontainer frissítése
Updating the container=A Kontainer frissítése
VNC Remote=VNC Remote
WebUI=WebUI
Yes, delete it=Igen, töröld!
Yes, update it=Igen, frissítse!
Yes=Igen

; footer messages
Array Copying=Tömb másolása
Array Clearing=Tömb törlése
Array Starting=Tömb indítása
Array Stopping=Tömb leállítása
Mounting disks=Csatlakoztatott lemezek
Spinning up all drives=Az összes meghajtó felébresztése
Starting services=Szolgáltatások indítása
Stopping services=Szolgáltatások leállítása
Unmounting disks=Lemezek leválasztása
Autostart disabled=Automatikus indítás letiltva
Missing encryption key=Hiányzik a titkosítási kulcs
Opening encrypted volumes=Titkosított kötetek megnyitása

; docker variables
Container Path=Konténer útvonala
Container Port=Konténer Port
Container Variable=Konténerváltozó
Container Label=Konténercímke
Container Device=Konténer eszközök

; Note: April 29, 2023 - 5 missing translations
Retry unmounting user shares=Retry unmounting user share(s)
Stale configuration=
Starting Recycle Bin=
Stopping Recycle Bin=
Sync filesystems=
