A format is NEVER part of a data recovery or disk rebuild process and if done in such circumstances will normally lead to loss of all data on the disks being formatted=A formátum **SOHA** része az adat-helyreállítási vagy lemez-újraépítési folyamatnak, és ha ilyen körülmények között teszik, az általában a formázandó lemezeken lévő összes adat elvesztéséhez vezet
Aborted=Megszakítva
Action=Akció
Add Pool=Tárolókészlet hozzáadása
Add=Hozzáad
All existing data on this device will be OVERWRITTEN when array is Started=Az eszközön lévő összes adat FELÍRÁSRA kerül, amikor a Tömb elindul
Array Devices=Tömb eszközök
Array of %s devices=%s eszközök Tömbje
Array Operation=Tömbművelet
Attribute Name=Attribútum neve
Attributes not available=
Attributes=Attribútumok
auto=auto
Autotrim=
Balance Status=Tárhely állapota
Balance=Tárhely
Blacklisted=Feketelistán
Boot Device=Indítólemez
Boot system in UEFI mode=Rendszerindítás UEFI módban
btrfs balance status=BTRFS Tárhely állapota
btrfs check status=BTRFS check status
btrfs filesystem df=BTRFS fájlrendszer df
BTRFS operation is running=A BTRFS művelet fut
btrfs scrub status=btrfs scrub status
Canceled=Törölve
Cannot contact key-server Please check your=Nem lehet kapcsolatba lépni a kulcsszerverrel. Kérjük, ellenőrizze a
Capabilities not available=
Capabilities=Képességek
Check Filesystem Status=Ellenőrizze a fájlrendszer állapotát
Clear Stats=Statisztikák törlése
Clearing in progress=Törlés folyamatban
Click on FLASH above this message=Kattintson a **FLASH** elemre az üzenet felett
Click to spin down device=Kattintson az eszköz hibernálására
Click to spin up device=Kattintson az eszköz felébresztésére
Comments=Megjegyzések
complete=teljes
Completed without error=Hiba nélkül elkészült
completed=kész
Compression=
Configuration valid=Konfiguráció érvényes
Convert to raid0 mode=Konvertálás Raid 0 módba
Convert to raid1 mode=Konvertálás Raid 1 módba
Convert to raid10 mode=Konvertálás Raid 10 módba
Convert to raid1c3 mode=Konvertálás Raid 1c3 módba
Convert to raid1c4 mode=Konvertálás Raid 1c4 módba
Convert to raid5 mode see help=Átalakítás Raid 5 módba *lásd a súgót
Convert to raid6 mode see help=Átalakítás Raid 6 módba *lásd a súgót
Convert to single mode=Átalakítás egymódusúvá
Copying=Másolás
corrected=javítva
Create an empty file system on the disks shown as Unmountable discarding all data currently on the disks and update parity to reflect this=Hozzon létre egy üres fájlrendszert a **Csatolatlan** jelzésű lemezeken, a lemezeken jelenleg lévő összes adat elvetése és a paritás frissítése hogy ezt tükrözze
creating Flash backup zip file this may take several minutes=Flash biztonsági zip fájl létrehozása (ez több percig is eltarthat)
Creating Flash backup=Flash biztonsági másolat készítése
Creation error=Létrehozási hiba
Critical disk temperature threshold=Kritikus lemez hőmérsékleti küszöb
Critical disk utilization threshold=Kritikus lemezhasználati küszöb
Current operation %s on %s=Jelenlegi művelet %s, a/z **%s**
Current position=Jelenlegi pozíció
Custom attributes use comma to separate numbers=Egyéni attribútumok (a számok elválasztásához használjon vesszőt)
Data-Rebuild in progress=Adat-újraépítés folyamatban
Date of purchase=Vásárlás dátuma
Date=Dátum
Delete Pool=Lemezkészlet törlése
detected=észlelt
Device encrypted and unlocked=Eszköz titkosítva és feloldva
Device encrypted=Eszköz titkosítva
Device is part of a pool=Az eszköz egy pool része
Device locked unknown error=Eszköz zárolva: ismeretlen hiba
Device locked wrong encryption key=Az eszköz zárolva: rossz titkosítási kulcs
Device to be encrypted=Titkosítandó eszköz
Disable Spin down delay to run a SMART extended self-test=**Lepörgetés késleltetésének kikapcsolása** SMART kiterjesztett önteszt futtatásához
Disk in parity slot is not biggest=A paritásos nyílásban lévő lemez nem a legnagyobb
Disk Log Information=Lemeznapló információ
Disk-Clear in progress=Lemeztörlés folyamatban
Do not use reserved names=Ne használjon felhasznált neveket
Do not use user share names=Ne használjon felhasználói megosztási neveket
Download SMART report=Töltse le a SMART jelentést
Dual parity valid requires ALL disks in their original slots=*Kettős paritás* érvényességéhez **MINDEN** lemezre van szükség az eredeti nyílásban
Elapsed time=Eltelt idő
Enable user share assignment=Felhasználói megosztási hozzárendelés engedélyezése
encrypted=titkosított
Encryption input=Titkosítási bemenet
Encryption status=Titkosítás állapota
enter disk index and device name as applicable to your controller=írja be a lemezindexet és az eszköznevet a vezérlőnek megfelelően
Enter new key=Írja be az új kulcsot
Erase Device Content=Eszköztartalom törlése
Errors occurred - Check SMART report=Hibák történtek – Ellenőrizze a SMART jelentést
Estimated finish=Becsült befejezés
Estimated speed=Becsült sebesség
Existing content is permanently lost=A meglévő tartalom végleg elveszett
Failed=Sikertelen
Feature=Funkció
File system status=Fájlrendszer állapota
File system type=Fájlrendszer típusa
Finding %s error=Megtalált: **%s** hiba
Finding %s errors=Megtalált: **%s** hiba
Flag=Zászló
Flash backup=Flash biztonsági mentés
Flash device is set as public share=A Flash-eszköz nyilvános megosztásként van beállítva
Flash Device Settings=Flash-eszköz beállításai
Format Unmountable disks=Csatolatlan lemezek formázása
Formatting=Formázás
formatting=formázás
Free=Ingyenes
FS=FS
Global Configuration=Globális konfiguráció
Hide=Elrejtés
Identification=Azonosítás
Identity is not available=
Identity=Identitás
if checked, Start array but do not mount disks=ha be van jelölve, indítsa el a tömböt, de ne csatlakoztassa a lemezeket
If this is a new array, move the largest disk into the parity slot=Ha ez egy új tömb, helyezze át a legnagyobb lemezt a *paritás* nyílásba
If you are adding a new disk or replacing a disabled disk, try Parity-Swap=Ha új lemezt ad hozzá vagy letiltott lemezt cserél, próbálkozzon a Parity-Swap használatával
Incorrect confirmation=
Information=Információ
Insufficient free disk space available=Nincs elég szabad lemezterület
Interrupted=Megszakítva
Invalid configuration=Érvénytelen konfiguráció
invalid device=érvénytelen eszköz
invalid devices=érvénytelen eszközök
Invalid expansion=Érvénytelen kiterjesztés
Invalid pool name=Érvénytelen készletnév
Invalid, missing or expired=Érvénytelen, hiányzó vagy lejárt
is only available when array is Started in Maintenance mode=csak akkor érhető el, ha a Tömb **Karbantartás** módban van elindítva
is only available when array is Started=csak akkor érhető el, ha a Tömb elindult
Keyfile=Kulcsfájl
Last check completed on %s=Utolsó ellenőrzés befejezve: **%s**
Last check incomplete on %s=Utolsó ellenőrzés nem fejeződött be: **%s**
Last checked on %s=Utolsó ellenőrzés: **%s**
Last SMART test result=Utolsó SMART teszt eredménye
Maintenance mode=Karbantartási mód
Maintenance Mode=Karbantartási mód
Maintenance=Karbantartás
Manufacturing date=Gyártási dátum
Menu View=Menü Nézet
Minimum free space=Minimális szabad hely
mirror=
Missing Cache disk=Hiányzó gyorsítótár-lemez
Missing disk=Hiányzó lemez
Missing key=Hiányzó kulcs
Missing=Hiányzik
Mounted=Felcsatolva
Mover is running=A Költöztető fut
network settings=hálózati beállítások
New data disks detected=Új adatlemez(ek) észlelve
next device=következő eszköz
No array data disks have been assigned=Nincs Tömb adatlemez hozzárendelve
No data disks=Nincs adatlemez
no devices=
No parity check history present=Nincs jelen paritásellenőrzési előzmény
No self-tests logged on this disk=Ezen a lemezen nincs bejelentkezve önteszt
Not installed=Nincs telepítve
Not present=
OK=OK
Once copy completes, the array may be Started, to initiate Data-Rebuild of the disabled disk=A másolás befejeztével a Tömb elindítható a letiltott lemez adat-újraépítésének elindításához
operation=művelet
Options see Help=Opciók (lásd Súgó)
Otherwise use the keyfile method for UTF8 input=Egyébként használja a **keyfile** metódust UTF-8 bevitelhez
Parity disks content will be overwritten=*Paritás* lemez(ek) tartalma felül lesz írva
Parity is already valid=A paritás már érvényes
Parity Operation History=Paritásos működési előzmények
Parity operation is running=A paritásművelet fut
Parity valid requires ALL disks to have their original content=*Érvényes paritás* megköveteli, hogy az **ÖSSZES** lemeznek legyen eredeti tartalma
Parity-Check in progress=Paritás-ellenőrzés folyamatban
ParityRead-Check History=Paritás/Olvasási-ellenőrzési előzmények
Parity-Sync in progress=Paritás-szinkronizálás folyamatban
Parity-SyncData-Rebuild in progress=Paritás-szinkronizálás/Adat-újraépítés folyamatban
Partition format=Partíció formátuma
Partition size=Partíció mérete
Passed=Sikerült
Passphrase=Jelszó
Perform full balance=Teljes egyensúly végrehajtása
Permit UEFI boot mode=Engedélyezze az UEFI rendszerindítási módot
Please change share SMB security=Kérjük, módosítsa a megosztási SMB-biztonságot
Please check your system settings to support UEFI boot mode=Kérjük, ellenőrizze a rendszerbeállításokat, hogy támogassa az UEFI boot módot
Please try again=
Pool Devices=Tárolókészleti eszközök
Pool name already exists=A készlet neve már létezik
Pool of %s devices=%s eszközkészlet
Pool Status=
Preclear in progress=Előtörlés folyamatban
previous device=előző eszköz
Printable Characters Only=Csak nyomtatható karakterek
Proceed to start=Folytassa a kezdéssel
raid0=
raid1=
raid10=
raid1c3=
raid1c4=
raid5=
raid6=
raidz=
raidz2=
raidz3=
Raw Value=Raw érték
Raw View=Raw nézet
Read-Check in progress=Olvasás-ellenőrzés folyamatban
Reading=Olvasás
Reboot in safe mode=Újraindítás csökkentett módban
Registration Key Manager=Regisztrációs kulcskezelő
registration key=regisztrációs kulcs
ReiserFS is deprecated, please use another file system=
reiserfsck status=reiserfsck status
Rename Pool=Tárolókészlet átnevezése
Repair corrupted blocks=A sérült blokkok javítása
Replacement disk installed=Cserelemez telepítve
Replacement disk is too small=A cserelemez túl kicsi
Retype passphrase=Írja be újra a jelszót
Schedule=Ütemező
Scrub Status=Súrolás állapota
Scrub=Súrolás
See %s Settings=Lásd: %s beállításokat
self-test in progress=önteszt folyamatban
Self-Test=Önteszt
Server boot mode=Szerver boot mod
Set default boot menu=Állítsa be az alapértelmezett rendszerindítási menüt
show passphrase=jelmondat megjelenítése
Show=Show
single=
Slots=Tárolórekesz
SMART attribute notifications=SMART attribútum értesítések
SMART controller type=SMART vezérlő típusa
SMART error log=SMART hibanapló
SMART extended self-test=SMART kiterjesztett önteszt
SMART health-check failed=SMART állapotellenőrzés sikertelen
SMART notification tolerance level=SMART értesítési tolerancia szint
SMART notification value=SMART értesítési érték
SMART self-test history=SMART öntesztelőzmények
SMART self-test in progress=SMART önteszt folyamatban
SMART Settings=SMART beállítások
SMART short self-test=SMART rövid önteszt
SMART status=SMART állapot
Speed=Sebesség
Spin down delay=Hibernálás késleltetés
Spin Down=Hibernálás
Spin Up=Ébresztés
Spinup groups=Csoport(os) ébresztés
Started, array protected=Elindult, A Tömb védett
Started, array unprotected=Elindult, A Tömb védtelen
Started, clearing=Elindult, törlés
Started, formatting=Elindult, formázás
Starting, copying=Indítás, másolás
Starting=Indítás
Stopping=Leállás
Sync errors corrected=Szinkronizálási hibák javítva
Sync errors detected=Szinkronizálási hibák észlelve
Sync errors=Szinkronizálási hibák
Sync=Sync
Syslinux Configuration=Syslinux konfiguráció
Syslinux configuration=Syslinux konfiguráció
Temp=Temp
The array will be immediately available, but unprotected since parity has not been assigned=A tömb azonnal elérhető lesz, de **védtelen**, mivel a *paritás* nincs hozzárendelve
The array will be immediately available, but unprotected until Parity-Sync completes=A tömb azonnal elérhető lesz, de **védtelen**, amíg a **Paritás-szinkronizálás** be nem fejeződik
The replacement disk must be as big or bigger than the original=A cserelemeznek akkorának vagy nagyobbnak kell lennie, mint az eredeti
This is typically done when a new disk is added to the array to get it ready for files to be written to it=Ez általában akkor történik, amikor egy új lemezt adnak a tömbhöz, hogy készen álljon a fájlok írására
This Unraid OS release has been withdrawn and may no longer be used Please=Ez az Unraid OS kiadás visszavonva, és többé nem használható. Kérem
This will ERASE ALL device content=Ezzel TÖRLI MINDEN eszköztartalmat
This will ERASE content of ALL devices in the pool=Ezzel TÖRÖLI a Tárolókészlet ÖSSZES eszköz tartalmát
This will reboot the system=Ezzel újraindul a rendszer
This will shutdown the system=Ez leállítja a rendszert
This will stop the array=Ez leállítja a tömböt
This will stop the running operation=Ez leállítja a futó műveletet
Threshold=Küszöb
Title=Cím
To confirm your action type %s=A művelet típusának megerősítéséhez: %s
Toggle readswrites display=Az olvasási/írási megjelenítés váltása
Too many attached devices Please consider upgrading your=Túl sok csatlakoztatott eszköz. Kérjük, fontolja meg a frissítését
Too many wrong andor missing disks=Túl sok rossz és/vagy hiányzó lemez
Total size=Teljes méret
Unassign ALL devices to delete this pool=A készlet törléséhez szüntesse meg az **MINDEN** eszköz hozzárendelését
Unassigned Devices=Hozzá nem rendelt eszközök
Unavailable - disk must be spun up=Nem érhető el – a lemezt fel kell ébreszteni
unavailable no parity-check entries logged=nem érhető el (nincs naplózott paritás-ellenőrző bejegyzés)
Unavailable=Nem elérhető
Unclean shutdown detected=Tiszta leállás észlelve
Unmountable disk present=Csatolatlan lemez van jelen
Unmountable disks present=Csatolatlan lemezek vannak jelen
Unmountable Encrypted volume present=Csatolatlan: Titkosított kötet van jelen
Unmountable Missing encryption key=Csatolatlan: Hiányzik a titkosítási kulcs
Unmountable No file system=Csatolatlan: Nincs fájlrendszer
Unmountable No pool uuid=Csatolatlan: Nincs uuid Tárolókészlet
Unmountable not btrfs pool=Csatolatlan: nem btrfs Tárolókészlet
Unmountable Unsupported or no file system=Csatolatlan: Nem támogatott vagy nincs fájlrendszer
Unmountable Volume not encrypted=Csatolatlan: A kötet nincs titkosítva
Unmounted=Csatolatlan
Upgrading diskswapping parity=Lemez frissítése/csere paritás
Use ASCII characters from space to tilde=**ASCII** karakterek használata a szóköztől a '~' hullámvonalig
Use Default=Alapértelmezett használata
Use default=Alapértelmezett használata
Use only lowercase with no special characters or leadingtrailing digits=Csak kisbetűt használjon speciális karakterek vagy kezdő/záró számjegyek nélkül
use printable characters only=csak nyomtatható karaktereket használjon
Used=Használt
Value=Érték
WARNING canceling may leave the array unprotected=FIGYELMEZTETÉS: A megszakítás védtelen maradhat a tömb
Warning disk temperature threshold=Figyelmeztető lemez hőmérsékleti küszöb
Warning disk utilization threshold=Figyelmeztető lemezhasználati küszöb
WARNING=FIGYELMEZTETÉS
Warranty period=Garanciaidő
will activate a clean system power down=aktiválja a *tiszta* rendszer kikapcsolását
will activate a clean system reset=aktiválja a *clean* rendszer visszaállítását
will bring the array on-line and start Clearing new data disks=elindítja a Tömböt, és megkezdi az **új adatlemez(ek) törlését**
will bring the array on-line and start Data-Rebuild=elindítja a Tömböt, és megkezdi az **Adat-újraépítést**
will bring the array on-line and start Disk-Clear of new data disks=elindítja a Tömböt, és megkezdi az új adatlemez(ek) **Lemeztörlését**
will bring the array on-line and start Parity-Check=elindítja a Tömböt, és megkezdi a **Paritás-ellenörzést**
will bring the array on-line and start Parity-Sync andor Data-Rebuild=elindítja a Tömböt, és megkezdi a **Paritás-szinkronizálást** és/vagy az **Adat-újraépítést**
will bring the array on-line and start Parity-Sync=elindítja a Tömböt, és megkezdi a **Paritás-szinkronizálást**
will bring the array on-line=hozza a tömböt Online módba
will copy the parity information to the new parity disk=átmásolja a paritásinformációkat az új *paritás* lemezre
will create a file system in all Unmountable disks=fájlrendszert hoz létre minden **Csatolatlan** lemezen
will delete the encryption keyfile=törli a titkosítási kulcsfájlt
will disable the missing disk and then bring the array on-line Install a replacement disk as soon as possible=letiltja a hiányzó lemezt, majd online állapotba hozza a Tömböt. A lehető leghamarabb telepítsen egy cserelemezt
will expand the file system of the data disk if possible then bring the array on-line and start Data-Rebuild=kibővíti az adatlemez fájlrendszerét (ha lehetséges); majd kapcsolja be a Tömböt, és indítsa el az Adat-újraépítési programot
will immediately clear all disk statistics=azonnal törli az összes lemezstatisztikát
will immediately invoke the Mover=azonnal előhívja a Költöztetőt
will immediately spin down all disks=azonnal hibernálja az összes lemezt
will immediately spin up all disks=azonnal felébreszti az összes lemezt
will pause Data-Rebuild=szünetelteti az **Adat-újraépítést**
will pause Disk-Clear=szünetelteti a **Lemeztörlést**
will pause Parity-Check=szünetelteti a **Paritás-ellenörzést**
will pause Parity-Sync=szünetelteti a **Paritás-szinkronizálást**
will pause Read-Check=szünetelteti az **Olvasás-ellenőrzést**
will pause the Clearing=szünetelteti a **Törlést**
will pause the Parity-Check=szünetelteti a **Paritás-ellenörzést**
will pause the Parity-SyncData-Rebuild=szünetelteti a **Paritás-szinkronizálást**/**Adat-újraépítést**
will pause the Read-Check=szünetelteti az **Olvasási-ellenörzést**
will record all disk information and bring the array on-line=rögzíti az összes lemezinformációt, és elindítja a Tömböt
will record all disk information, bring the array on-line, and start Parity-Sync=rögzíti az összes lemezinformációt, elindítja a Tömböt, és megkezdi a **Paritás-szinkronizálást**
will remove the missing cache disk and then bring the array on-line=eltávolítja a hiányzó Gyorsítótár lemezt, majd elindítja a Tömböt
will resume Data-Rebuild=folytatja az **Adat-újraépítést**
will resume Disk-Clear=folytatja a **Lemeztörlést**
will resume Parity-Check=folytatja a **Paritás-ellenörzést**
will resume Parity-Sync=folytatja a **Paritás-szinkronizálást**
will resume Read-Check=folytatja az **Olvasás-ellenőrzést**
will resume the paused Clearing=folytatja a **Törlést**
will resume the paused Parity-Check=folytatja a **Paritás-ellenörzést**
will resume the paused Parity-SyncData-Rebuild=folytatja a **Paritás-szinkronizálást**/**Adat-újraépítést**
will resume the paused Read-Check=folytatja az **Olvasási-ellenörzést**
will start Clearing new data disks=elindul **új adatlemez(ek) törlése**
will start Data-Rebuild=elindul az **Adat-újraépítés**
will start Disk-Clear of new data disks=elindul az új adatlemez(ek) **Lemeztörlése**
will start Parity-Check=elindul a **Paritás-ellenörzés**
will start Parity-Sync andor Data-Rebuild=elindul a **Paritás-szinkronizálás** és/vagy a ** Adat-újraépítés**
will start Parity-Sync=elindul a **Paritás-szinkronizálás**
will start Read-Check of all array disks=elindítja az összes tömblemez **Olvasás-ellenőrzése** funkcióját
will stop Clearing=leállítja a **Törlést**
will stop Data-Rebuild=leállítja a **Adat-újraépítést**
will stop Disk-Clear=leállítja a **Lemeztörlést**
will stop Parity-Check=leállítja a **Paritás-ellenörzést**
will stop Parity-Sync=leállítja a **Paritás-szinkronizálást**
will stop Parity-SyncData-Rebuild=leállítja a **Paritás-szinkronizálást**/**Adat-újraépítés** funkciót
will stop Read-Check=leállítja az **Olvasás-ellenőrzést**
will stop the Parity-Check=leállítja a **Paritás-ellenörzést**
will stop the Read-Check=leállítja a **Olvasási-ellenörzést**
will take the array off-line=Tömb leállítása
Worst=Legrosszabb
Write corrections to parity=Írja be a paritás javításait
Writes=Ír
Wrong key=Rossz kulcs
Wrong Pool State=
xfs_repair status=xfs_repair status
You may not add new disks and also remove existing disks=Nem adhat hozzá új lemez(eke)t, és nem távolíthat el meglévő lemez(eke)t
your server=a Szervered
zfs pool status=
zfs=

; Sleep plugin translations
Check this=Ellenőrizze ezt
for more information=további információkért
Make sure your server supports S3 sleep=Győződjön meg arról, hogy a szervere támogatja az S3 alvási funkciót
Sleep will immediately put the server in sleep mode=Az **Alvás** azonnal alvó módba helyezi a szervert
Sleeping=Alvás
System in sleep mode=A rendszer alvó üzemmódban
This will put the system in sleep mode=Ezzel a rendszer alvó módba kerül
wiki entry=wiki bejegyzés

; Note: March 17, 2023 - 26 missing translations
