Add Share=Megosztás hozzáadása
All files encrypted=Minden fájl titkosítva
All files protected=Minden fájl védett
All files unprotected=Minden fájl védtelen
Allocation method=Kiosztási módszer
Array must be Started to view Shares=A megosztások megtekintéséhez a tömbnek **Fut** jelzőnek kell lennie
Automatically split any directory as required=Bármely könyvtár automatikus felosztása szükség szerint
Automatically split only the top five directory levels as required=Csak az első öt könyvtárszint automatikus felosztása szükség szerint
Automatically split only the top four directory levels as required=Csak a felső négy könyvtárszint automatikus felosztása szükség szerint
Automatically split only the top level directory as required=Csak a legfelső szintű könyvtár automatikus felosztása szükség szerint
Automatically split only the top three directory levels as required=Automatikusan csak a felső három könyvtárszintet osztja fel szükség szerint
Automatically split only the top two directory levels as required=Csak a felső két könyvtárszint automatikus felosztása szükség szerint
Comments=Megjegyzés
Compute All=Összes kiszámítása
Compute=Felbecsül
Disk Shares=Lemezmegosztások
Do not use pool names=Ne használjon Gyorsítótár neveket
Do not use reserved names=Ne használjon felhasznált neveket
Enable Copy-on-write=Engedélyezze a Copy-on-Write funkciót
Enter a name for the share=Adja meg a Megosztás nevét
Excluded disks=Kizárt lemez(ek)
Export=Exportálás
Fill-up=Feltöltés (Fill-up)
Free=Ingyenes
has been deleted=törölve lett
HDD=HDD
High-water=Magasvíz (High-water)
Included disks=Tartalmazott lemez(ek)
Invalid Characters=Érvénytelen karakterek
Invalid share name=Érvénytelen megosztási név
Manual do not automatically split directories=Kézi: nem osztja fel automatikusan a könyvtárakat
Minimum free space=Minimális szabad hely
Missing share name=Hiányzó megosztási név
Most-free=Legszabadabb (Most-free)
Mover takes no action=A Költöztető nem tesz semmit
Mover transfers files from array to cache=A Költöztető fájlokat helyez át a Tömbből a Gyorsítótárba
Mover transfers files from cache to array=A Költöztető fájlokat helyez át a gyorsítótárból a Tömbbe
next user share=következő felhasználói megosztás
Only=Csak
Prefer=Inkább
previous user share=előző felhasználói megosztás
Read=Másolás
Recompute=Újraszámítás
Rule=Szabály
Select cache pool=Válassza ki a Gyorsítótár rekeszt
Set when adding new share only=Csak új megosztás hozzáadásakor állítsa be
Share contains data=A megosztás adatokat tartalmaz
Share is empty=A megosztás üres
Share is outside the list of designated disks=A megosztás kívül esik a kijelölt lemezek listáján
Share Settings=Megosztási beállítások
Share status=Megosztás állapota
Size=Méret
Some or all files unencrypted=Néhány vagy az összes fájl titkosítatlan
Some or all files unprotected=Néhány vagy az összes fájl védtelen
Split level=Osztott szint
SSD=SSD
There are no exportable disk shares=Nincsenek exportálható lemezmegosztások
There are no exportable user shares=Nincsenek exportálható felhasználói megosztások
Time Machine volume size limit=Apple Time Machine kötet méretkorlátja
Unknown encryption state=Ismeretlen titkosítási állapot
Use cache pool for new filesdirectories=Gyorsítótár használata (új fájlokhoz/könyvtárakhoz)
User Shares=Felhasználói megosztások
Write=Ír
You cannot use the following within share names=Nem használhatja a következőt a Megosztási nevek-ben

; Note: April 29, 2023 - 17 missing translations
Calculated free space value=
Clean Up=
CLEAN UP=
Exclusive access=
Mover action=
Mover transfers files from Primary storage to Secondary storage=
Mover transfers files from Secondary storage to Primary storage=
No unused share configurations present=
Not used=
Primary storage %s=
Primary storage for new files and folders=Primary storage (for new files and folders)
Primary storage to Secondary storage=
Remove unused share configurations=
Removed share configurations=
Secondary storage to Primary storage=
Secondary storage=
Storage=
