20 EHCI=2.0 (EHCI)
30 nec XHCI=3.0 (nec XHCI)
30 qemu XHCI=3.0 (qemu XHCI)
Allocation=Kiosztás
and if using graphics device passthrough it too needs UEFI=és ha grafikus eszközt használ, annak is szüksége van UEFI-re
Are you sure=Biztos vagy ebben
Array must be started to view Virtual Machines=A virtuális gépek megtekintéséhez el kell indítani a **started** Tömböt
Autostart=Automatikus indítás
Back=Vissza
Bus=Bus
Capacity=Kapacitás
Change Icon=Ikon módosítása
Cleanup=Tisztítás
Click and Select cdrom image to install operating system=Kattintson és válassza ki a ISO képet az operációs rendszer telepítéséhez
Config Folder=Konfigurációs mappa
Copy Paste Domain XML Configuration Here=Másolás &amp; Illessze be ide a tartomány XML konfigurációját
CPU Mode=CPU mód
CPUs=CPU-k
Create=Létrehozás
Creating=Létrehozás
define the amount memory=határozza meg a memória mennyiségét
define the maximum amount of memory=határozza meg a maximális memóriamennyiséget
define type of cpu presented to this vm=határozza meg az ehhez a virtuális géphez bemutatott processzor típusát
description of virtual machine=virtuális gép leírása
Disk devices=Lemezeszközök
Download Folder=Mappa letöltése
Download, Click and Select virtio drivers image=Töltse le, kattintson és válassza ki a virtio illesztőprogramok képét
Downloading=Letöltés
eg=e.g.
Emulated=Emulált
ETA=ETA
Extracting=Kicsomagolás
Folder to save the LibreELEC image to=Mappa a LibreELEC kép mentéséhez
Folder to save the OpenELEC image to=Mappa az OpenELEC kép mentéséhez
Form View=Űrlapnézet
free=ingyenes
Graphics Card=Grafikus kártya
Graphics ROM BIOS=Grafikus ROM BIOS
Graphics=Grafika
Host Passthrough=Host Passthrough
Hyperv tweaks for Windows=Hyperv módosítások Windowshoz
Hyper-V=Hyper-V
i440fx will work for most=Az i440fx a legtöbben működik
Icon=Ikon
Initial=Kezdeti
Invalid VM to edit=Érvénytelen szerkeszthető virtuális gép
ISO storage path doesnt exist, please create the user share or empty folder first=Az ISO tárhely elérési útja nem létezik, kérjük, először hozza létre a felhasználói megosztást (vagy üres mappát)
ISO storage path doesnt exist=Az ISO tárolási elérési út nem létezik
ISO storage path was empty=Az ISO tárolási útvonal üres volt
keyboard for VNC=billentyűzet VNC-hez
LibreELEC Version=LibreELEC Verzió
LibreELEC=LibreELEC
Libvirt Service failed to start=A Libvirt szolgáltatás elindítása nem sikerült
Logical CPUs=Logikai CPU-k
Machine=Gép
Manual=Kézikönyv
Max=Max
MD5 verification failed, your download is incomplete or corrupted=Az MD5 ellenőrzése sikertelen, a letöltés hiányos vagy sérült
mount tag inside vm=mount tag a vm belsejében
My Workstation=Saját munkaállomás
name of mount tag inside vm=a csatolási címke neve a vm-ben
Name of virtual machine=A virtuális gép neve
Network Bridge=Hálózati híd
Network MAC=Hálózati MAC
Network Model=HÁlózati Model
No Virtual Machines installed=Virtuális gép nincs telepítve
None available=Egyik sem elérhető
Not enough free space, need at least=Nincs elég szabad hely, legalább kell
Not running=Nem fut
OpenELEC Version=OpenELEC Verzió
OpenELEC=OpenELEC
OS Install CDRom Bus=Az operációs rendszer CDROM busz telepítése
OS Install ISO=Az operációs rendszer ISO
Other PCI Devices=Egyéb PCI eszközök
OVMF requires a UEFI-compatable OS=Az OVMF-hez UEFI-kompatibilis operációs rendszerre van szükség
OVMF TPM=OVMF TPM
OVMF=OVMF
password for VNC=VNC jelszó
path of Unraid share=az Unraid megosztás útja
path on Unraid share to save LibreELEC settings=elérési út az Unraid megosztáson a LibreELEC beállítások mentéséhez
path on Unraid share to save OpenELEC settings=elérési út az Unraid megosztáson az OpenELEC beállításainak mentéséhez
Path to ROM BIOS file=A ROM BIOS-fájl elérési útja
Please choose a folder the LibreELEC image will download to=Kérjük, válasszon mappát, ahová a LibreELEC képet letölti
Please choose a folder the OpenELEC image will download to=Kérjük, válassza ki azt a mappát, amelybe az OpenELEC-kép letöltődik
Pop-up Blocker is enabled Please add this site to your exception list=A felugró ablak blokkolva van! Kérjük, adja hozzá ezt a webhelyet a kivételek listájához
Primary=Elsődleges
Q35 for a newer machine model with PCIE=Q35 egy újabb PCIE-s gépmodellhez
QEMU64=QEMU64
random mac, you can supply your own=random MAC, akkor a saját
re-generate random mac address=véletlenszerű MAC-cím újragenerálása
Remove LibreELEC image=Távolítsa el a LibreELEC képet
Remove OpenELEC image=Az OpenELEC kép eltávolítása
Remove this LibreELEC file=Távolítsa el ezt a LibreELEC fájlt
Remove this OpenELEC file=Távolítsa el ezt az OpenELEC-fájlt
SeaBIOS will work for most=A SeaBIOS a legtöbben működik
SeaBIOS=SeaBIOS
Select the BIOS=BIOS kiválasztása
Select the LibreELEC version to use=Válassza ki a használni kívánt LibreELEC verziót
Select the machine model=Válassza ki a gép modelljét
Select the OpenELEC version to use=Válassza ki a használni kívánt OpenELEC verziót
Select the USB Controller to emulate=Válassza ki az emulálni kívánt USB-vezérlőt
Separate sub-folder and image will be created based on Name=A Név alapján külön almappa és kép jön létre
shares=megosztások
Some OSes wont support USB3=Egyes operációs rendszerek nem támogatják az USB3-at
Sound Card=Hangkártya
Specify a ISO storage path first=Először adjon meg egy ISO tárolási útvonalat
Start All=Összes indítása
Start VM after creation=Indítsa el a virtuális gépet a létrehozás után
Stop All=Összes leállítása
Toggle VM autostart=Kapcsolja be a VM automatikus indítását
type of storage image=a tárolási kép típusa
Unknown action=Ismeretlen művelet
Unknown version=Ismeretlen verzió
Unraid Share=Unraid megosztás
Updating=Frissítés
USB Controller=USB vezérlő
USB Devices=USB-eszközök
vDisk Bus=vDisk Bus
vDisk Location=vDisk helye
vDisk Size=vDisk nagyság
vDisk Type=vDisk tipusa
vDisks=vDisk-ek
Verifying=Ellenőrzés
video for VNC=videó VNC-hez
VirtIO Drivers CDRom Bus=VirtIO illesztőprogramok CDROM busz
VirtIO Drivers ISO=VirtIO illesztőprogramok ISO
Virtual Machines=Virtuális gépek
VM creation error=VM létrehozási hiba
VM image deletion error=VM-kép törlési hiba
VNC Keyboard=VNC billentyűzet
VNC Password=VNC jelszó
VNC Video Driver=VNC videó illesztőprogram
VNC=VNC
Wasnt able to stop the process=Nem sikerült megállítani a folyamatot
Windows 7XP=Windows 7/XP
Windows 82012, newer Linux distros=Windows 8/2012, újabb Linux disztribúciók
XML View=XML nézet (Haladó)

; Note: April 29, 2023 - 40 missing translations
9p Mode=
Boot Order=
Boot order=
define OS boot options=
Eject CD Drive=
Enable USB boot=
Guest agent not installed=
Guest not running or guest agent not installed=
Guest not running=
Insert CD=
Insert=
Interfaces=
Invalid storage path=
IP Address=
ISO Image=
Lock sortable items=
Network Source=
No CD image inserted in to drive=
Optional=
port for virtual console=
Prefix=
protocol for virtual console=
Select=
Serial=
Unlock sortable items=
Unraid Mount tag=
Unraid Mount Tag=
Unraid Share Mode=
Unraid Source Path=
Virtiofs Mode=
Virtual=
VM Console AutoPort=
VM Console enable Copypaste=VM Console enable Copy/paste
VM Console Keyboard=
VM Console Password=
VM Console Port=
VM Console Protocol=
VM Console Video Driver=
VM Console WS Port=
wsport for virtual console=
