Automatic theming=Automatikus tematika
Bing API key=Bing API kulcs
Bing=Bing
City name=Város Név
Country name=Ország neve
Day theme=Napi téma
Geocoding service=Geokódoló szolgáltatás
Google API key=Google API kulcs
Google=Google
MapQuest API key=MapQuest API kulcs
MapQuest=MapQuest
Night theme=Éjszakai téma
No geographical coordinates found for the given address=Nem találhatók földrajzi koordináták a megadott címhez
Please adjust=Kérjük, állítsa be
Postal code=Irányítószám
See=Lát
Street address=Cím
this site=ez az oldal
to obtain a Bing API key=Bing API kulcs beszerzése
to obtain a Google API key=oogle API kulcs beszerzése
to obtain a MapQuest API key=MapQuest API kulcs beszerzése

:day_night_plug:
> Enter your address information (street, city, country) which is used to calculate the sunrise and sunset times of your location.
>
> A geocoding service is used to convert your address to geographical (latitude and longitude) coordinates.<br>
> You need to register with one of the available services and get a unique API key to make use of their service.
>
> The **day** theme is selected between sunrise and sunset<br>
> The **night** theme is selected between sunset and sunrise
:end
